###                 #########
#  ## #################   # #
# ###                 # # # #
# ################### # # # #
#                     # # # #
##################### # # # #
#   ##                # # # #
# # ## ### ## ###### ## # #w#
# #    #   ##B#         # #w#
# # ## ################ # #w#
### ##             #### # # #
### ############## ## # # # #
###wwww         ##    # # # #
######w######## ####### # # #
######w####             #   #
A      ######################
